00000000000000000000
00000000000000000000
00000000000000000000
00000000000000000000
00000011111111100000
00010110001100000000
00111100000111000000
01100000000001000000
11000111110001111110
01111111110100010000
00000010101111111111
00000011111000100000
00000000001000100000
00000000001111100000
00000000000000000000
00000000000000000000
00000000000000000000
00000000000000000000
00000000000000000000
00000000000000000000
