00000000000000000000
00101101111110100110
01111001010010001010
01000111000110110100
11100001110010010000
00111101000011011111
01100001001110010010
01010011101011110010
01011111101001000010
01010000000001000010
01010011111101111010
01010010000101001000
01011110000101101000
01010001111100001000
01000110101001111110
01111000000001001000
01001111111111001000
01001000001010000100
00101101111011110010
00000000000000000000
