00000000000000000000
01110011111101111000
00010010000110001000
11110011011001111000
01011110010011001000
01000000011010011000
01001110101010000000
01001010001011111110
01111011111000000000
01000000001111110011
01000011100000010110
01111110101110110100
00100000110001100100
00001111100110100100
01101001000100101100
00111000000100111000
00001111111101000100
00000100001010101010
00000111101100010000
00000000000000000000
